"Player","year","rz_COMP","rz_ATT_pass","rz_PCT_pass","rz_YDS_pass","rz_Y/A","rz_TD_pass","rz_INT","rz_SACKS","rz_ATT_rush","rz_YDS_rush","rz_TD_rush","rz_PCT_rush","rz_FL","rz_G","rz_FPTS","rz_FPTS/G","rz_ROST %","rz_TD_total","rz_YDS_total","rz_ATT_total"
Patrick Mahomes,2018,64,100,"64.0%",478,4.8,35,1,7,14,47,2,"100.0%",0,16,175.8,11.0,"99.9%",37,525,114
Andrew Luck,2018,61,92,"66.3%",451,4.9,30,1,3,3,14,0,"100.0%",0,16,139.4,8.7,"2.2%",30,465,95
Drew Brees,2018,67,93,"72.0%",396,4.3,22,0,2,6,13,4,"27.3%",0,15,129.1,8.6,"35.7%",26,409,99
Deshaun Watson,2018,40,73,"54.8%",308,4.2,20,0,14,16,92,4,"100.0%",0,16,125.5,7.8,"33.2%",24,400,89
Cam Newton,2018,39,57,"68.4%",269,4.7,19,2,4,16,54,4,"100.0%",0,14,116.2,8.3,"9.1%",23,323,73
Ben Roethlisberger,2018,51,90,"56.7%",341,3.8,20,4,1,5,25,3,"100.0%",0,16,114.1,7.1,"13.6%",23,366,95
Matt Ryan,2018,45,72,"62.5%",352,4.9,21,1,9,5,9,3,"100.0%",2,16,113.0,7.1,"0.1%",24,361,77
Russell Wilson,2018,36,63,"57.1%",291,4.6,24,2,7,7,16,0,"100.0%",0,16,109.2,6.8,"7.4%",24,307,70
Jared Goff,2018,55,95,"57.9%",391,4.1,20,2,5,7,14,2,"100.0%",0,16,109.0,6.8,"70.0%",22,405,102
Mitchell Trubisky,2018,38,61,"62.3%",241,4.0,18,1,3,6,35,3,"100.0%",0,14,103.1,7.4,"0.1%",21,276,67
Philip Rivers,2018,41,69,"59.4%",278,4.0,21,2,4,9,-5,0,"100.0%",0,16,94.6,5.9,"20.6%",21,273,78
Kirk Cousins,2018,45,69,"65.2%",289,4.2,19,0,7,6,27,1,"100.0%",1,16,94.3,5.9,"58.9%",20,316,75
Aaron Rodgers,2018,31,73,"42.5%",240,3.3,16,1,3,8,38,2,"100.0%",0,16,89.4,5.6,"67.8%",18,278,81
Eli Manning,2018,38,82,"46.3%",250,3.0,18,1,4,6,11,1,"100.0%",0,16,89.1,5.6,"2.3%",19,261,88
Dak Prescott,2018,34,64,"53.1%",192,3.0,10,2,7,19,72,6,"100.0%",1,16,88.9,5.6,"94.4%",16,264,83
Baker Mayfield,2018,35,51,"68.6%",256,5.0,19,0,2,7,3,0,"87.5%",0,14,86.5,6.2,"30.2%",19,259,58
Tom Brady,2018,43,79,"54.4%",308,3.9,14,1,5,6,8,2,"100.0%",0,16,81.1,5.1,"2.7%",16,316,85
Carson Wentz,2018,34,58,"58.6%",240,4.1,18,1,4,5,0,0,"71.4%",1,11,79.6,7.2,"0.2%",18,240,63
Derek Carr,2018,40,64,"62.5%",235,3.7,15,2,3,5,4,1,"100.0%",0,16,75.8,4.7,"7.5%",16,239,69
Andy Dalton,2018,31,48,"64.6%",234,4.9,16,1,1,1,2,0,"25.0%",0,11,73.6,6.7,"0.1%",16,236,49
Jameis Winston,2018,27,46,"58.7%",233,5.1,12,2,2,8,38,1,"40.0%",0,11,67.1,6.1,"0.3%",13,271,54
Matthew Stafford,2018,32,66,"48.5%",206,3.1,13,3,5,2,8,0,"100.0%",0,16,61.0,3.8,"44.0%",13,214,68
Case Keenum,2018,32,62,"51.6%",211,3.4,10,3,1,2,2,2,"100.0%",0,16,60.6,3.8,"0.1%",12,213,64
Sam Darnold,2018,23,42,"54.8%",225,5.4,10,1,4,11,16,1,"100.0%",0,13,56.6,4.4,"4.4%",11,241,53
Josh Allen,2018,8,21,"38.1%",43,2.0,2,1,3,19,91,6,"90.5%",0,12,54.8,4.6,"99.9%",8,134,40
Ryan Fitzpatrick,2018,15,38,"39.5%",99,2.6,9,2,4,12,32,2,"60.0%",1,8,53.2,6.7,"0.0%",11,131,50
Marcus Mariota,2018,28,51,"54.9%",160,3.1,8,1,4,12,20,2,"100.0%",0,14,52.4,3.7,"0.1%",10,180,63
Joe Flacco,2018,25,47,"53.2%",155,3.3,10,1,0,3,0,0,"8.8%",0,9,46.2,5.1,"0.7%",10,155,50
Lamar Jackson,2018,9,22,"40.9%",61,2.8,4,0,4,31,98,3,"91.2%",0,16,46.2,2.9,"99.8%",7,159,53
Alex Smith,2018,18,31,"58.1%",130,4.2,7,1,5,10,40,1,"76.9%",0,10,43.2,4.3,"5.0%",8,170,41
Ryan Tannehill,2018,13,22,"59.1%",129,5.9,8,1,1,4,6,0,"66.7%",0,11,37.8,3.4,"0.1%",8,135,26
Blake Bortles,2018,16,38,"42.1%",105,2.8,7,2,4,4,20,0,"50.0%",0,13,34.2,2.6,"0.0%",7,125,42
Josh Rosen,2018,15,35,"42.9%",131,3.7,6,0,0,0,0,0,"0.0%",0,14,29.2,2.1,"0.0%",6,131,35
Nick Mullens,2018,18,29,"62.1%",114,3.9,6,2,2,2,1,0,"18.2%",0,8,28.7,3.6,"0.1%",6,115,31
Jeff Driskel,2018,8,19,"42.1%",59,3.1,4,0,1,3,23,1,"75.0%",0,9,26.7,3.0,"0.0%",5,82,22
CJ Beathard,2018,11,20,"55.0%",70,3.5,4,1,0,4,9,1,"36.4%",0,6,25.7,4.3,"0.0%",5,79,24
Jimmy Garoppolo,2018,9,16,"56.3%",76,4.8,3,0,6,5,20,0,"45.5%",0,3,17.0,5.7,"0.2%",3,96,21
Josh Johnson,2018,4,9,"44.4%",28,3.1,2,1,1,2,6,1,"15.4%",0,4,15.7,3.9,"0.1%",3,34,11
Blaine Gabbert,2018,6,7,"85.7%",59,8.4,3,0,1,0,0,0,"0.0%",0,8,14.4,1.8,"0.0%",3,59,7
Chase Daniel,2018,5,11,"45.5%",31,2.8,3,0,0,0,0,0,"0.0%",0,5,13.2,2.6,"0.0%",3,31,11
Tyrod Taylor,2018,1,2,"50.0%",17,8.5,1,0,1,1,20,1,"12.5%",0,4,12.7,3.2,"0.2%",2,37,3
Brock Osweiler,2018,7,15,"46.7%",32,2.1,3,0,1,2,2,0,"33.3%",1,7,11.5,1.6,"0.0%",3,34,17
Nathan Peterman,2018,4,4,"100.0%",31,7.8,1,0,0,1,1,1,"4.8%",0,4,11.3,2.8,"0.0%",2,32,5
Nick Foles,2018,13,22,"59.1%",68,3.1,2,1,0,2,4,0,"28.6%",0,5,11.1,2.2,"0.0%",2,72,24
Cody Kessler,2018,6,13,"46.2%",41,3.2,2,0,0,4,8,0,"50.0%",0,6,10.4,1.7,"0.1%",2,49,17
Colt McCoy,2018,4,7,"57.1%",33,4.7,2,0,1,1,4,0,"7.7%",0,3,9.7,3.2,"0.0%",2,37,8
Matt Barkley,2018,4,7,"57.1%",33,4.7,2,0,0,1,0,0,"4.8%",0,1,9.3,9.3,"0.0%",2,33,8
Josh McCown,2018,4,11,"36.4%",34,3.1,1,0,2,0,0,0,"0.0%",0,4,5.4,1.4,"0.0%",1,34,11
Taylor Heinicke,2018,5,8,"62.5%",24,3.0,1,1,0,0,0,0,"0.0%",0,6,5.0,0.8,"0.0%",1,24,8
Mike Glennon,2018,3,6,"50.0%",19,3.2,1,0,0,0,0,0,"0.0%",0,2,4.8,2.4,"1.0%",1,19,6
Sam Bradford,2018,3,6,"50.0%",6,1.0,0,0,0,1,8,0,"100.0%",0,3,1.0,0.3,"0.0%",0,14,7
Derek Anderson,2018,2,3,"66.7%",5,1.7,0,0,1,0,0,0,"0.0%",0,2,0.2,0.1,"0.0%",0,5,3
Geno Smith,2018,0,1,"0.0%",0,0.0,0,0,0,0,0,0,"0.0%",0,5,0.0,0.0,"19.9%",0,0,1
Teddy Bridgewater,2018,0,0,"0%",0,0.0,0,0,0,3,-3,0,"13.6%",0,5,-0.3,-0.1,"0.0%",0,-3,3
DeShone Kizer,2018,1,1,"100.0%",2,2.0,0,0,1,0,0,0,"0.0%",1,3,-1.9,-0.6,"0.0%",0,2,1
Lamar Jackson,2019,41,63,"65.1%",310,4.9,26,0,3,28,102,5,"82.4%",0,15,156.6,10.4,"99.8%",31,412,91
Deshaun Watson,2019,34,62,"54.8%",297,4.8,18,3,4,16,38,6,"100.0%",0,15,130.3,8.7,"33.2%",24,335,78
Russell Wilson,2019,39,79,"49.4%",330,4.2,23,1,2,12,50,3,"100.0%",0,16,128.2,8.0,"7.4%",26,380,91
Josh Allen,2019,26,53,"49.1%",168,3.2,13,0,6,22,73,9,"100.0%",0,16,120.0,7.5,"99.9%",22,241,75
Carson Wentz,2019,45,76,"59.2%",300,3.9,21,0,6,13,56,1,"100.0%",0,16,107.6,6.7,"0.2%",22,356,89
Matt Ryan,2019,43,77,"55.8%",321,4.2,21,2,3,3,17,1,"100.0%",0,15,104.5,7.0,"0.1%",22,338,80
Jameis Winston,2019,40,73,"54.8%",329,4.5,20,2,5,8,5,1,"100.0%",0,16,99.7,6.2,"0.3%",21,334,81
Ryan Fitzpatrick,2019,35,62,"56.5%",304,4.9,16,1,3,14,43,3,"100.0%",0,15,98.5,6.6,"0.0%",19,347,76
Jacoby Brissett,2019,29,57,"50.9%",174,3.1,15,0,3,14,43,4,"100.0%",0,15,95.5,6.4,"1.3%",19,217,71
Tom Brady,2019,56,97,"57.7%",359,3.7,15,2,3,11,8,3,"91.7%",0,16,93.2,5.8,"2.7%",18,367,108
Drew Brees,2019,43,58,"74.1%",298,5.1,18,1,4,1,1,1,"6.3%",0,11,90.0,8.2,"35.7%",19,299,59
Dak Prescott,2019,30,59,"50.8%",260,4.4,14,0,3,14,46,3,"100.0%",0,16,89.0,5.6,"94.4%",17,306,73
Baker Mayfield,2019,31,74,"41.9%",180,2.4,15,4,4,6,20,3,"100.0%",0,16,87.2,5.5,"30.2%",18,200,80
Aaron Rodgers,2019,49,79,"62.0%",325,4.1,16,2,1,9,25,1,"100.0%",0,16,85.5,5.3,"67.8%",17,350,88
Kyler Murray,2019,40,69,"58.0%",262,3.8,12,2,6,19,81,3,"95.0%",0,16,84.6,5.3,"92.2%",15,343,88
Jared Goff,2019,43,65,"66.2%",247,3.8,15,0,2,10,6,2,"100.0%",1,16,80.5,5.0,"70.0%",17,253,75
Jimmy Garoppolo,2019,48,74,"64.9%",296,4.0,16,2,4,10,4,1,"100.0%",1,16,80.2,5.0,"0.2%",17,300,84
Kirk Cousins,2019,31,52,"59.6%",196,3.8,16,1,4,3,4,1,"100.0%",0,15,78.2,5.2,"58.9%",17,200,55
Derek Carr,2019,39,63,"61.9%",272,4.3,14,2,3,4,10,2,"100.0%",1,16,77.9,4.9,"7.5%",16,282,67
Ryan Tannehill,2019,25,36,"69.4%",183,5.1,13,3,3,4,20,3,"50.0%",1,12,77.3,6.4,"0.1%",16,203,40
Kyle Allen,2019,31,53,"58.5%",191,3.6,14,2,6,4,23,2,"80.0%",2,14,73.9,5.3,"0.0%",16,214,57
Daniel Jones,2019,31,57,"54.4%",180,3.2,12,0,2,5,37,2,"83.3%",0,13,70.9,5.5,"6.9%",14,217,62
Mitchell Trubisky,2019,26,53,"49.1%",164,3.1,14,4,2,6,15,1,"85.7%",0,15,70.1,4.7,"0.1%",15,179,59
Sam Darnold,2019,26,50,"52.0%",198,4.0,12,4,4,5,19,2,"100.0%",0,13,69.8,5.4,"4.4%",14,217,55
Patrick Mahomes,2019,30,57,"52.6%",213,3.7,11,1,4,7,45,2,"87.5%",1,14,67.0,4.8,"99.9%",13,258,64
Philip Rivers,2019,42,78,"53.8%",297,3.8,13,3,6,1,1,0,"100.0%",0,16,64.0,4.0,"20.6%",13,298,79
Gardner Minshew,2019,27,61,"44.3%",185,3.0,13,1,3,7,26,0,"100.0%",0,14,62.0,4.4,"3.5%",13,211,68
Andy Dalton,2019,34,68,"50.0%",221,3.3,9,2,6,6,14,3,"100.0%",2,13,60.2,4.6,"0.1%",12,235,74
Matthew Stafford,2019,24,42,"57.1%",162,3.9,11,1,3,2,4,0,"33.3%",1,8,48.9,6.1,"44.0%",11,166,44
Teddy Bridgewater,2019,18,29,"62.1%",131,4.5,7,0,1,9,6,0,"56.3%",0,10,33.8,3.4,"0.0%",7,137,38
Case Keenum,2019,20,33,"60.6%",121,3.7,6,0,2,4,4,1,"66.7%",1,10,33.2,3.3,"0.1%",7,125,37
Dwayne Haskins,2019,8,23,"34.8%",53,2.3,5,0,5,2,18,0,"33.3%",0,9,23.9,2.7,"0.1%",5,71,25
Mason Rudolph,2019,20,31,"64.5%",80,2.6,5,1,1,2,2,0,"22.2%",0,10,23.4,2.3,"0.1%",5,82,33
Drew Lock,2019,17,26,"65.4%",89,3.4,5,1,0,2,-3,0,"40.0%",0,5,23.3,4.7,"0.2%",5,86,28
Joe Flacco,2019,18,36,"50.0%",126,3.5,4,1,5,2,3,0,"40.0%",0,8,21.3,2.7,"0.7%",4,129,38
Marcus Mariota,2019,7,14,"50.0%",63,4.5,4,0,3,4,21,0,"50.0%",0,7,20.6,2.9,"0.1%",4,84,18
Brian Hoyer,2019,8,19,"42.1%",51,2.7,4,2,0,1,6,0,"8.3%",0,5,18.6,3.7,"0.0%",4,57,20
Jeff Driskel,2019,5,9,"55.6%",51,5.7,2,0,0,4,4,1,"66.7%",0,4,16.4,4.1,"0.0%",3,55,13
Chase Daniel,2019,5,8,"62.5%",44,5.5,3,0,1,1,2,0,"14.3%",0,5,14.0,2.8,"0.0%",3,46,9
David Blough,2019,8,15,"53.3%",41,2.7,3,0,1,0,0,0,"0.0%",0,5,13.6,2.7,"0.0%",3,41,15
Eli Manning,2019,9,13,"69.2%",47,3.6,3,0,1,1,0,0,"16.7%",1,4,11.9,3.0,"2.3%",3,47,14
Devlin Hodges,2019,8,13,"61.5%",50,3.8,2,1,0,6,-3,0,"66.7%",0,8,9.7,1.2,"0.0%",2,47,19
Matt Schaub,2019,6,9,"66.7%",35,3.9,2,0,0,0,0,0,"0.0%",0,7,9.4,1.3,"0.0%",2,35,9
Ryan Finley,2019,3,6,"50.0%",31,5.2,2,1,1,0,0,0,"0.0%",0,3,9.2,3.1,"0.0%",2,31,6
Brandon Allen,2019,3,12,"25.0%",10,0.8,1,1,0,1,11,0,"20.0%",0,3,5.5,1.8,"0.0%",1,21,13
Mike Glennon,2019,1,1,"100.0%",17,17.0,1,0,0,0,0,0,"0.0%",0,3,4.7,1.6,"1.0%",1,17,1
Robert GriffinI,2019,1,2,"50.0%",3,1.5,1,0,1,6,4,0,"17.6%",0,7,4.5,0.6,"1.0%",1,7,8
Tyrod Taylor,2019,2,2,"100.0%",12,6.0,1,0,0,0,0,0,"0.0%",0,8,4.5,0.6,"0.2%",1,12,2
Nick Foles,2019,5,6,"83.3%",49,8.2,1,0,1,0,0,0,"0.0%",1,4,4.0,1.0,"0.0%",1,49,6
Brett Hundley,2019,0,0,"0%",0,0.0,0,0,0,1,12,0,"5.0%",0,3,1.2,0.4,"0.0%",0,12,1
Ben Roethlisberger,2019,0,3,"0.0%",0,0.0,0,0,1,1,7,0,"11.1%",0,2,0.7,0.4,"13.6%",0,7,4
Matt Moore,2019,4,11,"36.4%",18,1.6,0,0,0,1,-1,0,"12.5%",0,6,0.6,0.1,"0.0%",0,17,12
Josh Rosen,2019,1,7,"14.3%",11,1.6,0,1,0,0,0,0,"0.0%",0,6,0.4,0.1,"0.0%",0,11,7
Will Grier,2019,2,6,"33.3%",8,1.3,0,0,1,1,0,0,"20.0%",0,2,0.3,0.2,"0.0%",0,8,7
Matt Barkley,2019,1,2,"50.0%",8,4.0,0,0,0,0,0,0,"0.0%",0,3,0.3,0.1,"0.0%",0,8,2
Cam Newton,2019,1,6,"16.7%",8,1.3,0,0,0,0,0,0,"0.0%",0,2,0.3,0.2,"9.1%",0,8,6
Luke Falk,2019,2,3,"66.7%",5,1.7,0,0,0,0,0,0,"0.0%",0,3,0.2,0.1,"0.1%",0,5,3
Josh McCown,2019,0,1,"0.0%",0,0.0,0,0,0,0,0,0,"0.0%",0,3,0.0,0.0,"0.0%",0,0,1
Aaron Rodgers,2020,56,79,"70.9%",308,3.9,32,0,2,4,23,3,"66.7%",0,16,160.6,10.0,"67.8%",35,331,83
Josh Allen,2020,52,84,"61.9%",330,3.9,23,0,4,24,53,7,"100.0%",2,16,155.7,9.7,"99.9%",30,383,108
Kyler Murray,2020,45,67,"67.2%",271,4.0,19,2,1,24,115,9,"100.0%",0,16,152.3,9.5,"92.2%",28,386,91
Ryan Tannehill,2020,44,68,"64.7%",346,5.1,25,2,4,7,41,4,"70.0%",0,16,141.9,8.9,"0.1%",29,387,75
Tom Brady,2020,52,85,"61.2%",337,4.0,27,0,4,7,5,3,"100.0%",0,16,140.0,8.8,"2.7%",30,342,92
Russell Wilson,2020,52,75,"69.3%",354,4.7,27,3,2,5,5,2,"83.3%",0,16,134.7,8.4,"7.4%",29,359,80
Patrick Mahomes,2020,48,81,"59.3%",299,3.7,26,2,3,10,26,2,"90.9%",1,15,128.6,8.6,"99.9%",28,325,91
Kirk Cousins,2020,40,63,"63.5%",335,5.3,26,0,3,4,18,0,"100.0%",1,16,117.2,7.3,"58.9%",26,353,67
Lamar Jackson,2020,39,57,"68.4%",260,4.6,18,0,4,31,120,4,"96.9%",3,15,112.4,7.5,"99.8%",22,380,88
Justin Herbert,2020,41,73,"56.2%",293,4.0,18,1,5,15,32,4,"100.0%",0,15,110.9,7.4,"60.3%",22,325,88
Deshaun Watson,2020,45,78,"57.7%",279,3.6,16,0,4,18,104,3,"100.0%",1,16,101.6,6.4,"33.2%",19,383,96
Cam Newton,2020,18,35,"51.4%",110,3.1,4,1,2,41,93,12,"95.3%",1,15,99.7,6.6,"9.1%",16,203,76
Ben Roethlisberger,2020,46,80,"57.5%",385,4.8,21,2,1,6,-3,0,"100.0%",0,15,99.1,6.6,"13.6%",21,382,86
Baker Mayfield,2020,42,67,"62.7%",270,4.0,20,0,2,11,20,1,"100.0%",0,16,98.8,6.2,"30.2%",21,290,78
Drew Brees,2020,41,65,"63.1%",339,5.2,18,1,0,3,3,2,"10.0%",0,12,97.9,8.2,"35.7%",20,342,68
Derek Carr,2020,44,81,"54.3%",276,3.4,16,1,2,11,40,3,"78.6%",0,16,97.0,6.1,"7.5%",19,316,92
Jared Goff,2020,37,56,"66.1%",246,4.4,15,1,3,7,12,4,"100.0%",1,15,93.0,6.2,"70.0%",19,258,63
Matt Ryan,2020,44,81,"54.3%",279,3.4,18,1,8,5,26,1,"100.0%",0,16,91.8,5.7,"0.1%",19,305,86
Carson Wentz,2020,28,52,"53.8%",201,3.9,12,3,5,12,41,5,"75.0%",0,12,90.1,7.5,"0.2%",17,242,64
Matthew Stafford,2020,37,68,"54.4%",267,3.9,17,3,3,6,21,0,"100.0%",0,16,80.8,5.1,"44.0%",17,288,74
Teddy Bridgewater,2020,31,53,"58.5%",170,3.2,9,1,2,18,104,5,"94.7%",2,15,79.2,5.3,"0.0%",14,274,71
Philip Rivers,2020,47,77,"61.0%",331,4.3,16,1,5,3,0,0,"50.0%",0,16,77.2,4.8,"20.6%",16,331,80
Drew Lock,2020,28,46,"60.9%",212,4.6,11,2,2,8,32,3,"80.0%",0,13,73.7,5.7,"0.2%",14,244,54
Gardner Minshew,2020,26,59,"44.1%",199,3.4,14,0,3,2,6,1,"66.7%",1,9,68.6,7.6,"3.5%",15,205,61
Mitchell Trubisky,2020,23,46,"50.0%",173,3.8,13,2,0,8,27,1,"80.0%",0,10,67.6,6.8,"0.1%",14,200,54
Joe Burrow,2020,30,55,"54.5%",193,3.5,12,2,6,10,19,2,"83.3%",1,10,67.6,6.8,"97.3%",14,212,65
Tua Tagovailoa,2020,18,32,"56.3%",97,3.0,9,1,1,8,15,3,"44.4%",0,10,59.4,5.9,"76.8%",12,112,40
Ryan Fitzpatrick,2020,17,34,"50.0%",108,3.2,10,3,2,10,26,2,"55.6%",0,10,58.9,5.9,"0.0%",12,134,44
Nick Mullens,2020,30,45,"66.7%",219,4.9,11,3,1,1,0,0,"100.0%",0,10,52.8,5.3,"0.1%",11,219,46
Andy Dalton,2020,26,45,"57.8%",149,3.3,11,2,4,2,1,0,"25.0%",0,11,50.1,4.6,"0.1%",11,150,47
Dak Prescott,2020,13,22,"59.1%",97,4.4,4,1,0,6,25,3,"75.0%",0,5,47.5,9.5,"94.4%",7,122,28
Nick Foles,2020,21,39,"53.8%",114,2.9,7,1,3,2,1,1,"20.0%",0,9,38.7,4.3,"0.0%",8,115,41
Daniel Jones,2020,33,63,"52.4%",154,2.4,6,3,1,4,25,0,"66.7%",0,14,32.7,2.3,"6.9%",6,179,67
Sam Darnold,2020,13,34,"38.2%",99,2.9,5,1,3,1,4,1,"50.0%",0,12,30.4,2.5,"4.4%",6,103,35
Dwayne Haskins,2020,15,23,"65.2%",109,4.7,4,0,3,7,2,1,"77.8%",1,7,24.6,3.5,"0.1%",5,111,30
Jimmy Garoppolo,2020,13,21,"61.9%",86,4.1,5,1,1,0,0,0,"0.0%",0,6,23.4,3.9,"0.2%",5,86,21
Joe Flacco,2020,6,12,"50.0%",64,5.3,4,0,0,1,5,0,"50.0%",0,5,19.1,3.8,"0.7%",4,69,13
Brandon Allen,2020,9,17,"52.9%",64,3.8,4,0,0,0,0,0,"0.0%",0,5,18.6,3.7,"0.0%",4,64,17
Jacoby Brissett,2020,0,1,"0.0%",0,0.0,0,0,1,3,4,3,"50.0%",0,11,18.4,1.7,"1.3%",3,4,4
Jalen Hurts,2020,5,9,"55.6%",34,3.8,3,1,5,4,8,1,"25.0%",1,15,18.2,1.2,"99.9%",4,42,13
Alex Smith,2020,14,26,"53.8%",99,3.8,3,1,5,0,0,0,"0.0%",0,8,16.0,2.0,"5.0%",3,99,26
Kyle Allen,2020,5,9,"55.6%",32,3.6,2,0,0,2,7,1,"22.2%",0,4,16.0,4.0,"0.0%",3,39,11
Jeff Driskel,2020,4,7,"57.1%",49,7.0,3,0,2,1,9,0,"10.0%",0,3,14.9,5.0,"0.0%",3,58,8
CJ Beathard,2020,8,10,"80.0%",58,5.8,3,0,2,0,0,0,"0.0%",0,6,14.3,2.4,"0.0%",3,58,10
Jake Luton,2020,3,5,"60.0%",18,3.6,1,1,0,1,13,1,"33.3%",0,3,12.0,4.0,"0.0%",2,31,6
Mike Glennon,2020,6,11,"54.5%",42,3.8,2,0,0,0,0,0,"0.0%",0,5,9.7,1.9,"1.0%",2,42,11
Marcus Mariota,2020,1,3,"33.3%",7,2.3,0,0,0,3,11,1,"21.4%",0,1,7.4,7.4,"0.1%",1,18,6
Chad Henne,2020,1,1,"100.0%",2,2.0,0,0,1,1,1,1,"9.1%",0,3,6.2,2.1,"0.1%",1,3,2
Ryan Finley,2020,4,5,"80.0%",33,6.6,1,1,1,2,8,0,"16.7%",0,5,6.1,1.2,"0.0%",1,41,7
PJ Walker,2020,3,5,"60.0%",29,5.8,1,2,0,1,2,0,"5.3%",0,4,5.4,1.4,"0.0%",1,31,6
Garrett Gilbert,2020,2,5,"40.0%",21,4.2,1,1,1,0,0,0,"0.0%",0,2,4.8,2.4,"0.0%",1,21,5
Chase Daniel,2020,3,5,"60.0%",18,3.6,1,0,0,0,0,0,"0.0%",0,4,4.7,1.2,"0.0%",1,18,5
Brett Rypien,2020,4,7,"57.1%",17,2.4,1,1,1,1,-1,0,"10.0%",0,3,4.6,1.5,"0.0%",1,16,8
Colt McCoy,2020,4,10,"40.0%",-2,-0.2,1,1,0,2,7,0,"33.3%",0,4,4.6,1.2,"0.0%",1,5,12
Jarrett Stidham,2020,1,3,"33.3%",4,1.3,1,0,0,2,-2,0,"4.7%",0,5,4.0,0.8,"0.6%",1,2,5
Robert GriffinI,2020,0,1,"0.0%",0,0.0,0,0,0,1,11,0,"3.1%",0,4,1.1,0.3,"1.0%",0,11,2
Jameis Winston,2020,2,4,"50.0%",18,4.5,0,0,2,1,3,0,"3.3%",0,4,1.0,0.3,"0.3%",0,21,5
Taylor Heinicke,2020,1,2,"50.0%",9,4.5,0,0,1,0,0,0,"0.0%",0,1,0.4,0.4,"0.0%",0,9,2
Matt Barkley,2020,1,1,"100.0%",11,11.0,0,0,1,0,0,0,"0.0%",0,5,0.4,0.1,"0.0%",0,11,1
Tim Boyle,2020,0,0,"0%",0,0.0,0,0,0,2,0,0,"33.3%",0,8,0.0,0.0,"0.0%",0,0,2
Tyrod Taylor,2020,0,4,"0.0%",0,0.0,0,0,0,0,0,0,"0.0%",0,2,0.0,0.0,"0.2%",0,0,4
AJ McCarron,2020,0,0,"0%",0,0.0,0,0,1,0,0,0,"0.0%",0,2,0.0,0.0,"0.0%",0,0,0
Geno Smith,2020,1,1,"100.0%",6,6.0,0,0,0,1,-2,0,"16.7%",0,1,0.0,0.0,"19.9%",0,4,2
Logan Woodside,2020,0,0,"0%",0,0.0,0,0,0,3,-5,0,"30.0%",0,6,-0.5,-0.1,"0.0%",0,-5,3
Ben DiNucci,2020,2,3,"66.7%",16,5.3,0,0,1,0,0,0,"0.0%",1,3,-1.4,-0.5,"0.1%",0,16,3
Brian Hoyer,2020,1,1,"100.0%",-4,-4.0,0,0,2,0,0,0,"0.0%",1,1,-2.2,-2.2,"0.0%",0,-4,1
Josh Allen,2021,67,121,"55.4%",427,3.5,27,2,3,30,139,6,"96.8%",0,17,175.0,10.3,"99.9%",33,566,151
Aaron Rodgers,2021,66,113,"58.4%",406,3.6,29,2,2,7,30,3,"100.0%",0,16,152.8,9.6,"67.8%",32,436,120
Tom Brady,2021,73,122,"59.8%",471,3.9,29,0,4,8,12,2,"72.7%",0,17,148.0,8.7,"2.7%",31,483,130
Justin Herbert,2021,60,106,"56.6%",417,3.9,27,2,6,22,42,3,"100.0%",1,17,144.9,8.5,"60.3%",30,459,128
Matthew Stafford,2021,59,109,"54.1%",443,4.1,29,1,5,7,9,0,"100.0%",1,17,132.6,7.8,"44.0%",29,452,116
Patrick Mahomes,2021,61,98,"62.2%",332,3.4,24,4,7,12,60,2,"85.7%",1,17,125.3,7.4,"99.9%",26,392,110
Jalen Hurts,2021,35,59,"59.3%",279,4.7,13,2,4,32,117,9,"100.0%",2,15,124.9,8.3,"99.9%",22,396,91
Ryan Tannehill,2021,44,77,"57.1%",306,4.0,15,3,7,14,32,7,"100.0%",0,17,117.4,6.9,"0.1%",22,338,91
Kirk Cousins,2021,47,79,"59.5%",349,4.4,24,1,3,5,2,1,"100.0%",0,16,116.2,7.3,"58.9%",25,351,84
Dak Prescott,2021,58,93,"62.4%",372,4.0,22,2,5,14,20,1,"100.0%",2,16,106.9,6.7,"94.4%",23,392,107
Kyler Murray,2021,37,69,"53.6%",265,3.8,15,2,3,25,59,5,"83.3%",0,14,106.5,7.6,"92.2%",20,324,94
Joe Burrow,2021,38,61,"62.3%",275,4.5,16,3,7,9,21,2,"90.0%",0,16,89.1,5.6,"97.3%",18,296,70
Matt Ryan,2021,45,81,"55.6%",320,4.0,17,0,4,11,8,1,"100.0%",0,17,87.6,5.2,"0.1%",18,328,92
Teddy Bridgewater,2021,39,63,"61.9%",292,4.6,15,1,4,11,37,2,"91.7%",0,14,87.4,6.2,"0.0%",17,329,74
Tua Tagovailoa,2021,35,53,"66.0%",163,3.1,14,1,1,9,29,3,"75.0%",0,13,83.4,6.4,"76.8%",17,192,62
Jimmy Garoppolo,2021,30,53,"56.6%",201,3.8,14,1,2,3,8,3,"37.5%",0,15,82.8,5.5,"0.2%",17,209,56
Carson Wentz,2021,38,68,"55.9%",225,3.3,18,1,7,9,15,1,"90.0%",3,17,82.5,4.9,"0.2%",19,240,77
Mac Jones,2021,43,72,"59.7%",275,3.8,17,1,1,7,16,0,"100.0%",0,17,80.6,4.7,"0.6%",17,291,79
Ben Roethlisberger,2021,42,82,"51.2%",266,3.2,16,0,4,4,-2,1,"80.0%",0,16,80.4,5.0,"13.6%",17,264,86
Taylor Heinicke,2021,33,52,"63.5%",236,4.5,14,4,5,11,42,1,"84.6%",0,16,75.6,4.7,"0.0%",15,278,63
Russell Wilson,2021,25,45,"55.6%",180,4.0,14,2,2,6,37,1,"85.7%",0,14,72.9,5.2,"7.4%",15,217,51
Lamar Jackson,2021,29,50,"58.0%",207,4.1,12,2,4,17,64,2,"77.3%",2,12,70.7,5.9,"99.8%",14,271,67
Derek Carr,2021,43,78,"55.1%",255,3.3,15,2,7,8,15,0,"66.7%",1,17,69.7,4.1,"7.5%",15,270,86
Baker Mayfield,2021,29,47,"61.7%",210,4.5,13,0,7,4,10,1,"40.0%",0,14,67.4,4.8,"30.2%",14,220,51
Sam Darnold,2021,19,39,"48.7%",136,3.5,6,2,2,8,35,5,"50.0%",1,12,60.9,5.1,"4.4%",11,171,47
Jameis Winston,2021,16,21,"76.2%",147,7.0,11,0,3,3,7,1,"15.8%",0,7,56.6,8.1,"0.3%",12,154,24
Zach Wilson,2021,26,43,"60.5%",138,3.2,6,0,5,9,10,3,"90.0%",0,13,48.5,3.7,"0.6%",9,148,52
Jared Goff,2021,28,55,"50.9%",199,3.6,10,2,1,3,-1,0,"75.0%",2,14,43.9,3.1,"70.0%",10,198,58
Trevor Siemian,2021,14,28,"50.0%",95,3.4,8,0,0,2,16,1,"10.5%",0,6,43.4,7.2,"0.0%",9,111,30
Daniel Jones,2021,16,42,"38.1%",70,1.7,5,0,4,13,48,2,"92.9%",0,11,39.6,3.6,"6.9%",7,118,55
Trevor Lawrence,2021,21,47,"44.7%",126,2.7,5,2,2,12,45,2,"100.0%",1,17,39.5,2.3,"60.6%",7,171,59
Cam Newton,2021,3,7,"42.9%",12,1.7,2,0,0,9,33,4,"56.3%",0,8,35.8,4.5,"9.1%",6,45,16
Tyrod Taylor,2021,9,23,"39.1%",59,2.6,3,2,2,4,32,3,"80.0%",0,6,35.6,5.9,"0.2%",6,91,27
Justin Fields,2021,19,33,"57.6%",125,3.8,5,0,2,10,38,1,"52.6%",0,12,34.8,2.9,"8.4%",6,163,43
Davis Mills,2021,17,26,"65.4%",120,4.6,7,0,3,1,3,0,"20.0%",0,13,33.1,2.5,"0.1%",7,123,27
Tyler Huntley,2021,18,24,"75.0%",95,4.0,3,0,3,5,18,2,"22.7%",1,7,27.6,3.9,"0.0%",5,113,29
Mike Glennon,2021,7,15,"46.7%",58,3.9,4,0,0,1,7,1,"7.1%",0,6,25.0,4.2,"1.0%",5,65,16
Andy Dalton,2021,13,22,"59.1%",90,4.1,5,2,0,7,11,0,"36.8%",0,8,24.7,3.1,"0.1%",5,101,29
Jacoby Brissett,2021,10,23,"43.5%",34,1.5,4,0,0,3,2,1,"25.0%",0,11,23.6,2.1,"1.3%",5,36,26
Mike White,2021,7,11,"63.6%",75,6.8,5,0,1,0,0,0,"0.0%",0,4,23.0,5.8,"0.1%",5,75,11
Trey Lance,2021,4,7,"57.1%",27,3.9,3,0,1,5,9,1,"62.5%",0,6,20.0,3.3,"0.2%",4,36,12
Josh Johnson,2021,8,14,"57.1%",79,5.6,4,1,0,1,4,0,"10.0%",0,4,19.6,4.9,"0.1%",4,83,15
Geno Smith,2021,5,10,"50.0%",29,2.9,3,0,2,1,1,1,"14.3%",0,4,19.3,4.8,"19.9%",4,30,11
Tim Boyle,2021,8,14,"57.1%",63,4.5,3,1,0,1,14,0,"25.0%",0,4,15.9,4.0,"0.0%",3,77,15
Colt McCoy,2021,5,10,"50.0%",15,1.5,2,0,1,5,21,0,"16.7%",0,8,10.7,1.3,"0.0%",2,36,15
Cooper Rush,2021,4,6,"66.7%",36,6.0,2,0,1,0,0,0,"0.0%",0,4,9.4,2.4,"0.1%",2,36,6
Marcus Mariota,2021,0,0,"0%",0,0.0,0,0,0,4,17,1,"33.3%",0,7,7.7,1.1,"0.1%",1,17,4
Joe Flacco,2021,3,7,"42.9%",22,3.1,2,0,1,0,0,0,"0.0%",1,2,6.9,3.5,"0.7%",2,22,7
Mason Rudolph,2021,5,11,"45.5%",36,3.3,1,0,0,1,11,0,"20.0%",0,2,6.5,3.3,"0.1%",1,47,12
Mitchell Trubisky,2021,0,0,"0%",0,0.0,0,0,0,1,4,1,"3.2%",0,5,6.4,1.3,"0.1%",1,4,1
PJ Walker,2021,5,8,"62.5%",47,5.9,1,0,2,-1,0,0,-6.3%,0,5,5.9,1.2,"0.0%",1,47,7
Nick Foles,2021,4,7,"57.1%",40,5.7,1,0,3,2,1,0,"10.5%",0,1,5.7,5.7,"0.0%",1,41,9
Case Keenum,2021,3,6,"50.0%",13,2.2,1,0,1,6,5,0,"60.0%",0,5,5.0,1.0,"0.1%",1,18,12
Brian Hoyer,2021,2,2,"100.0%",19,9.5,1,0,0,0,0,0,"0.0%",0,5,4.8,1.0,"0.0%",1,19,2
Kyle Allen,2021,2,2,"100.0%",19,9.5,1,0,0,1,0,0,"7.7%",0,2,4.8,2.4,"0.0%",1,19,3
Sean Mannion,2021,1,1,"100.0%",14,14.0,1,0,0,0,0,0,"0.0%",0,1,4.6,4.6,"0.0%",1,14,1
Nick Mullens,2021,2,3,"66.7%",12,4.0,1,0,0,0,0,0,"0.0%",0,1,4.5,4.5,"0.1%",1,12,3
Brandon Allen,2021,1,2,"50.0%",7,3.5,1,0,0,1,0,0,"10.0%",0,5,4.3,0.9,"0.0%",1,7,3
Jordan Love,2021,3,4,"75.0%",34,8.5,1,0,1,0,0,0,"0.0%",1,6,3.4,0.6,"93.4%",1,34,4
Drew Lock,2021,5,8,"62.5%",36,4.5,1,1,0,1,-2,0,"8.3%",1,6,3.3,0.6,"0.2%",1,34,9
Blaine Gabbert,2021,1,1,"100.0%",14,14.0,0,0,0,3,-1,0,"27.3%",0,6,0.5,0.1,"0.0%",0,13,4
Gardner Minshew,2021,3,3,"100.0%",9,3.0,0,0,1,0,0,0,"0.0%",0,3,0.4,0.1,"3.5%",0,9,3
Ryan Fitzpatrick,2021,1,1,"100.0%",6,6.0,0,0,0,1,2,0,"7.7%",0,1,0.4,0.4,"0.0%",0,8,2
Chad Henne,2021,1,1,"100.0%",8,8.0,0,0,0,2,0,0,"14.3%",0,4,0.3,0.1,"0.1%",0,8,3
Garrett Gilbert,2021,1,3,"33.3%",6,2.0,0,0,0,0,0,0,"0.0%",0,1,0.2,0.2,"0.0%",0,6,3
Sam Ehlinger,2021,0,0,"0%",0,0.0,0,0,0,1,1,0,"10.0%",0,3,0.1,0.0,"0.0%",0,1,1
Feleipe Franks,2021,0,0,"0%",0,0.0,0,0,0,0,0,0,"0.0%",0,6,0.0,0.0,"0.0%",0,0,0
Jake Fromm,2021,0,4,"0.0%",0,0.0,0,0,0,0,0,0,"0.0%",0,3,0.0,0.0,"0.0%",0,0,4
Chris Streveler,2021,0,1,"0.0%",0,0.0,0,0,0,0,0,0,"0.0%",0,2,0.0,0.0,"0.0%",0,0,1
Patrick Mahomes,2022,69,119,"58.0%",436,3.7,34,3,2,14,91,4,"100.0%",0,17,186.5,11.0,"99.9%",38,527,133
Josh Allen,2022,46,92,"50.0%",359,3.9,23,5,4,26,80,6,"92.9%",1,17,148.4,8.7,"99.9%",29,439,118
Joe Burrow,2022,54,89,"60.7%",407,4.6,24,1,2,21,52,5,"100.0%",0,17,147.5,8.7,"97.3%",29,459,110
Trevor Lawrence,2022,44,82,"53.7%",303,3.7,20,3,1,14,26,5,"100.0%",0,17,124.7,7.3,"60.6%",25,329,96
Jalen Hurts,2022,24,46,"52.2%",169,3.7,9,0,3,44,122,11,"95.7%",0,15,121.0,8.1,"99.9%",20,291,90
Kirk Cousins,2022,62,102,"60.8%",407,4.0,22,2,6,7,31,2,"100.0%",1,17,117.4,6.9,"58.9%",24,438,109
Jared Goff,2022,52,88,"59.1%",325,3.7,22,1,2,4,10,0,"100.0%",1,17,100.0,5.9,"70.0%",22,335,92
Daniel Jones,2022,27,42,"64.3%",180,4.3,12,1,3,25,78,6,"100.0%",0,16,99.0,6.2,"6.9%",18,258,67
Tom Brady,2022,58,103,"56.3%",333,3.2,19,0,3,11,1,1,"100.0%",0,17,95.4,5.6,"2.7%",20,334,114
Justin Fields,2022,23,37,"62.2%",181,4.9,12,1,4,29,66,5,"100.0%",0,15,91.8,6.1,"8.4%",17,247,66
Aaron Rodgers,2022,50,80,"62.5%",302,3.8,18,2,3,6,12,1,"100.0%",0,17,91.3,5.4,"67.8%",19,314,86
Geno Smith,2022,41,76,"53.9%",301,4.0,18,0,6,6,22,1,"100.0%",1,17,90.2,5.3,"19.9%",19,323,82
Dak Prescott,2022,39,55,"70.9%",292,5.3,17,1,4,6,31,1,"100.0%",0,12,88.8,7.4,"94.4%",18,323,61
Justin Herbert,2022,55,98,"56.1%",293,3.0,18,1,5,7,26,0,"100.0%",0,17,86.1,5.1,"60.3%",18,319,105
Lamar Jackson,2022,27,57,"47.4%",203,3.6,13,1,2,19,77,2,"63.3%",0,12,79.8,6.7,"99.8%",15,280,76
Marcus Mariota,2022,21,35,"60.0%",117,3.3,11,1,2,20,42,4,"80.0%",1,13,74.9,5.8,"0.1%",15,159,55
Tua Tagovailoa,2022,31,48,"64.6%",223,4.6,16,0,6,5,2,0,"83.3%",0,13,73.1,5.6,"76.8%",16,225,53
Davis Mills,2022,23,49,"46.9%",163,3.3,12,1,6,6,34,2,"75.0%",0,15,69.9,4.7,"0.1%",14,197,55
Jimmy Garoppolo,2022,26,43,"60.5%",183,4.3,12,1,4,5,6,2,"33.3%",0,11,67.9,6.2,"0.2%",14,189,48
Jacoby Brissett,2022,24,48,"50.0%",145,3.0,11,1,1,11,26,2,"64.7%",0,14,64.4,4.6,"1.3%",13,171,59
Kyler Murray,2022,24,47,"51.1%",122,2.6,9,0,1,11,32,3,"78.6%",0,11,62.1,5.6,"92.2%",12,154,58
Ryan Tannehill,2022,29,51,"56.9%",213,4.2,10,0,2,7,10,2,"70.0%",0,12,61.5,5.1,"0.1%",12,223,58
Matt Ryan,2022,27,52,"51.9%",202,3.9,12,0,5,4,3,1,"66.7%",1,12,60.4,5.0,"0.1%",13,205,56
Russell Wilson,2022,24,47,"51.1%",183,3.9,7,1,2,4,37,3,"100.0%",0,15,57.0,3.8,"7.4%",10,220,51
Andy Dalton,2022,31,49,"63.3%",250,5.1,11,1,4,6,7,0,"25.0%",0,14,54.7,3.9,"0.1%",11,257,55
Derek Carr,2022,25,59,"42.4%",175,3.0,11,2,0,5,12,0,"71.4%",0,15,52.2,3.5,"7.5%",11,187,64
Taylor Heinicke,2022,17,34,"50.0%",151,4.4,9,0,3,4,12,1,"44.4%",1,9,47.2,5.2,"0.0%",10,163,38
Kenny Pickett,2022,20,47,"42.6%",153,3.3,5,1,5,10,30,3,"76.9%",0,13,47.1,3.6,"0.7%",8,183,57
Carson Wentz,2022,17,33,"51.5%",139,4.2,7,1,2,5,23,1,"55.6%",0,8,41.9,5.2,"0.2%",8,162,38
Sam Darnold,2022,12,22,"54.5%",90,4.1,6,0,2,5,16,2,"45.5%",0,6,41.2,6.9,"4.4%",8,106,27
Matthew Stafford,2022,20,42,"47.6%",137,3.3,7,0,4,1,1,1,"33.3%",0,9,39.6,4.4,"44.0%",8,138,43
Baker Mayfield,2022,16,31,"51.6%",89,2.9,6,0,3,6,24,1,"54.5%",0,12,36.0,3.0,"30.2%",7,113,37
Zach Wilson,2022,8,17,"47.1%",58,3.4,5,0,4,8,18,1,"72.7%",1,9,34.3,3.8,"0.6%",6,76,25
Mac Jones,2022,20,36,"55.6%",110,3.1,6,1,5,7,-4,1,"87.5%",0,14,34.0,2.4,"0.6%",7,106,43
Mitchell Trubisky,2022,8,11,"72.7%",50,4.5,4,1,2,3,2,2,"23.1%",0,7,30.2,4.3,"0.1%",6,52,14
Brock Purdy,2022,10,15,"66.7%",48,3.2,4,1,3,5,4,1,"33.3%",0,9,24.3,2.7,"90.2%",5,52,20
Deshaun Watson,2022,9,27,"33.3%",67,2.5,3,1,4,6,16,1,"35.3%",0,6,22.3,3.7,"33.2%",4,83,33
Teddy Bridgewater,2022,8,9,"88.9%",70,7.8,4,0,1,1,10,0,"16.7%",0,5,19.8,4.0,"0.0%",4,80,10
Cooper Rush,2022,11,20,"55.0%",78,3.9,4,0,0,0,0,0,"0.0%",0,8,19.1,2.4,"0.1%",4,78,20
Tyler Huntley,2022,10,16,"62.5%",30,1.9,2,1,1,11,29,1,"36.7%",0,5,18.1,3.6,"0.0%",3,59,27
Jameis Winston,2022,8,14,"57.1%",46,3.3,4,0,1,0,0,0,"0.0%",0,3,17.8,5.9,"0.3%",4,46,14
Gardner Minshew,2022,2,6,"33.3%",23,3.8,2,0,0,2,4,1,"4.3%",0,5,15.3,3.1,"3.5%",3,27,8
Joe Flacco,2022,9,23,"39.1%",51,2.2,4,1,2,0,0,0,"0.0%",2,5,14.0,2.8,"0.7%",4,51,23
Mike White,2022,10,24,"41.7%",40,1.7,1,1,1,3,7,1,"27.3%",0,4,12.3,3.1,"0.1%",2,47,27
Malik Willis,2022,2,5,"40.0%",28,5.6,0,0,0,3,25,1,"30.0%",0,7,9.6,1.4,"0.1%",1,53,8
Brett Rypien,2022,3,5,"60.0%",10,2.0,2,0,0,0,0,0,"0.0%",0,4,8.4,2.1,"0.0%",2,10,5
Jarrett Stidham,2022,6,10,"60.0%",26,2.6,1,0,0,2,13,0,"28.6%",0,3,6.3,2.1,"0.6%",1,39,12
Colt McCoy,2022,7,12,"58.3%",38,3.2,1,0,0,2,5,0,"14.3%",0,4,6.0,1.5,"0.0%",1,43,14
John Wolford,2022,4,6,"66.7%",37,6.2,1,0,2,0,0,0,"0.0%",0,2,5.5,2.8,"0.0%",1,37,6
Bailey Zappe,2022,6,11,"54.5%",23,2.1,1,0,0,1,5,0,"12.5%",0,4,5.4,1.4,"0.0%",1,28,12
Kyle Allen,2022,5,9,"55.6%",31,3.4,1,0,0,0,0,0,"0.0%",0,3,5.2,1.7,"0.0%",1,31,9
PJ Walker,2022,1,3,"33.3%",20,6.7,1,0,0,0,0,0,"0.0%",0,6,4.8,0.8,"0.0%",1,20,3
Joshua Dobbs,2022,3,5,"60.0%",20,4.0,1,0,0,0,0,0,"0.0%",0,2,4.8,2.4,"0.7%",1,20,5
Tyrod Taylor,2022,1,1,"100.0%",19,19.0,1,0,0,0,0,0,"0.0%",0,3,4.8,1.6,"0.2%",1,19,1
Skylar Thompson,2022,3,5,"60.0%",15,3.0,1,0,0,0,0,0,"0.0%",0,7,4.6,0.7,"0.0%",1,15,5
David Blough,2022,2,6,"33.3%",13,2.2,1,0,0,0,0,0,"0.0%",0,2,4.5,2.3,"0.0%",1,13,6
Bryce Perkins,2022,2,5,"40.0%",13,2.6,1,0,0,2,0,0,"66.7%",0,5,4.5,0.9,"0.1%",1,13,7
Nick Mullens,2022,3,3,"100.0%",11,3.7,1,0,0,0,0,0,"0.0%",0,4,4.4,1.1,"0.1%",1,11,3
Trevor Siemian,2022,2,4,"50.0%",7,1.8,1,1,0,0,0,0,"0.0%",0,2,4.3,2.2,"0.0%",1,7,4
Sam Ehlinger,2022,5,6,"83.3%",20,3.3,1,0,4,1,0,0,"16.7%",1,4,2.8,0.7,"0.0%",1,20,7
Trey Lance,2022,1,1,"100.0%",5,5.0,0,0,1,4,19,0,"26.7%",0,3,2.1,0.7,"0.2%",0,24,5
Desmond Ridder,2022,4,10,"40.0%",14,1.4,0,0,1,5,8,0,"20.0%",0,4,1.4,0.4,"0.6%",0,22,15
Jacob Eason,2022,2,4,"50.0%",10,2.5,0,1,0,0,0,0,"0.0%",0,1,0.4,0.4,"0.0%",0,10,4
Nick Foles,2022,2,3,"66.7%",11,3.7,0,0,0,1,0,0,"16.7%",0,2,0.4,0.2,"0.0%",0,11,4
Davis Cheek,2022,0,0,"0%",0,0.0,0,0,0,0,0,0,"0.0%",0,1,0.0,0.0,"0.0%",0,0,0
Chase Daniel,2022,0,2,"0.0%",0,0.0,0,0,1,0,0,0,"0.0%",0,3,0.0,0.0,"0.0%",0,0,2
Chris Streveler,2022,0,1,"0.0%",0,0.0,0,0,0,0,0,0,"0.0%",0,1,0.0,0.0,"0.0%",0,0,1
Jordan Love,2022,0,1,"0.0%",0,0.0,0,0,0,0,0,0,"0.0%",0,4,0.0,0.0,"93.4%",0,0,1
Brian Hoyer,2022,1,2,"50.0%",-1,-0.5,0,0,0,0,0,0,"0.0%",0,1,0.0,0.0,"0.0%",0,-1,2
Nate Sudfeld,2022,0,0,"0%",0,0.0,0,0,1,0,0,0,"0.0%",0,2,0.0,0.0,"0.0%",0,0,0
Jeff Driskel,2022,2,4,"50.0%",1,0.3,0,0,1,2,0,0,"25.0%",0,7,0.0,0.0,"0.0%",0,1,6
Josh Johnson,2022,0,0,"0%",0,0.0,0,0,0,1,-1,0,"6.7%",0,1,-0.1,-0.1,"0.1%",0,-1,1
Case Keenum,2022,0,0,"0%",0,0.0,0,0,0,2,-2,0,"7.1%",0,2,-0.2,-0.1,"0.1%",0,-2,2
Trace McSorley,2022,1,3,"33.3%",-1,-0.3,0,1,1,1,2,0,"7.1%",1,5,-1.8,-0.4,"0.2%",0,1,4
Josh Allen,2023,40,68,"58.8%",282,4.1,18,0,6,33,134,15,"94.3%",0,17,186.7,11.0,"99.9%",33,416,101
Jalen Hurts,2023,32,54,"59.3%",224,4.1,13,1,6,44,88,15,"100.0%",1,17,157.8,9.3,"99.9%",28,312,98
Jordan Love,2023,51,94,"54.3%",315,3.4,23,3,7,9,23,4,"100.0%",0,17,130.9,7.7,"93.4%",27,338,103
Dak Prescott,2023,55,98,"56.1%",390,4.0,24,2,7,14,82,2,"100.0%",1,17,129.8,7.6,"94.4%",26,472,112
Lamar Jackson,2023,43,64,"67.2%",282,4.4,17,2,4,32,122,5,"91.4%",0,16,121.5,7.6,"99.8%",22,404,96
Russell Wilson,2023,47,76,"61.8%",312,4.1,20,1,8,19,20,3,"100.0%",1,15,110.5,7.4,"7.4%",23,332,95
Patrick Mahomes,2023,59,97,"60.8%",341,3.5,24,2,5,13,16,0,"100.0%",1,16,109.2,6.8,"99.9%",24,357,110
Brock Purdy,2023,49,70,"70.0%",367,5.2,19,2,3,7,28,2,"100.0%",0,16,105.5,6.6,"90.2%",21,395,77
Jared Goff,2023,44,78,"56.4%",309,4.0,18,0,1,12,14,2,"100.0%",0,17,97.8,5.8,"70.0%",20,323,90
Sam Howell,2023,30,61,"49.2%",170,2.8,12,3,1,8,36,5,"88.9%",0,17,88.4,5.2,"0.7%",17,206,69
CJ Stroud,2023,29,63,"46.0%",215,3.4,15,2,3,9,30,3,"81.8%",1,15,87.6,5.8,"98.9%",18,245,72
Justin Herbert,2023,38,68,"55.9%",189,2.8,15,1,3,12,34,3,"85.7%",1,13,87.0,6.7,"60.3%",18,223,80
Matthew Stafford,2023,40,83,"48.2%",257,3.1,18,0,3,3,4,0,"100.0%",0,15,82.7,5.5,"44.0%",18,261,86
Trevor Lawrence,2023,29,54,"53.7%",217,4.0,12,1,4,13,28,4,"100.0%",1,16,81.5,5.1,"60.6%",16,245,67
Justin Fields,2023,26,47,"55.3%",170,3.6,11,1,4,22,56,4,"84.6%",0,13,80.4,6.2,"8.4%",15,226,69
Joshua Dobbs,2023,30,50,"60.0%",157,3.1,11,1,2,11,53,4,"45.8%",0,13,79.6,6.1,"0.7%",15,210,61
Geno Smith,2023,28,65,"43.1%",208,3.2,15,2,5,8,25,1,"100.0%",0,15,76.8,5.1,"19.9%",16,233,73
Baker Mayfield,2023,32,64,"50.0%",205,3.2,14,1,6,13,3,1,"100.0%",0,17,70.5,4.1,"30.2%",15,208,77
Tua Tagovailoa,2023,43,73,"58.9%",256,3.5,16,1,6,8,3,0,"100.0%",2,17,70.5,4.1,"76.8%",16,259,81
Derek Carr,2023,34,65,"52.3%",222,3.4,15,1,2,6,2,0,"16.7%",0,17,69.1,4.1,"7.5%",15,224,71
Desmond Ridder,2023,26,43,"60.5%",157,3.7,8,3,3,12,55,5,"92.3%",3,15,67.8,4.5,"0.6%",13,212,55
Gardner Minshew,2023,32,61,"52.5%",224,3.7,10,1,5,7,28,3,"46.7%",1,16,67.8,4.2,"3.5%",13,252,68
Kirk Cousins,2023,25,50,"50.0%",186,3.7,12,3,1,4,6,0,"57.1%",0,8,56.0,7.0,"58.9%",12,192,54
Kyler Murray,2023,15,24,"62.5%",100,4.2,7,0,3,12,35,3,"50.0%",0,8,53.5,6.7,"92.2%",10,135,36
Joe Burrow,2023,35,51,"68.6%",198,3.9,11,2,2,2,4,0,"20.0%",0,10,52.3,5.2,"97.3%",11,202,53
Bryce Young,2023,22,44,"50.0%",133,3.0,11,0,8,7,13,0,"87.5%",1,16,48.6,3.0,"8.6%",11,146,51
Jake Browning,2023,21,32,"65.6%",156,4.9,5,2,1,8,9,3,"80.0%",0,9,45.1,5.0,"0.6%",8,165,40
Aidan O'Connell,2023,33,45,"73.3%",195,4.3,7,1,0,6,-2,1,"66.7%",0,11,41.6,3.8,"1.3%",8,193,51
Mac Jones,2023,19,29,"65.5%",144,5.0,8,1,3,0,0,0,"0.0%",0,11,37.8,3.4,"0.6%",8,144,29
Deshaun Watson,2023,14,19,"73.7%",90,4.7,6,0,3,3,27,1,"33.3%",0,6,36.3,6.1,"33.2%",7,117,22
Tommy DeVito,2023,9,15,"60.0%",52,3.5,6,0,0,4,19,1,"28.6%",0,10,34.0,3.4,"0.2%",7,71,19
Anthony Richardson,2023,4,6,"66.7%",32,5.3,1,0,1,8,44,4,"53.3%",0,4,33.7,8.4,"97.9%",5,76,14
Bailey Zappe,2023,7,9,"77.8%",70,7.8,5,0,0,1,17,1,"100.0%",0,10,30.5,3.1,"0.0%",6,87,10
Zach Wilson,2023,20,38,"52.6%",136,3.6,6,1,7,2,8,0,"66.7%",0,12,30.2,2.5,"0.6%",6,144,40
Jimmy Garoppolo,2023,12,21,"57.1%",79,3.8,6,2,1,3,11,0,"33.3%",0,7,28.3,4.0,"0.2%",6,90,24
Tyson Bagent,2023,11,18,"61.1%",91,5.1,3,0,1,4,6,2,"15.4%",0,5,28.2,5.6,"0.2%",5,97,22
Will Levis,2023,7,20,"35.0%",46,2.3,4,1,3,3,14,1,"50.0%",0,9,25.2,2.8,"13.4%",5,60,23
Joe Flacco,2023,14,27,"51.9%",79,2.9,5,2,0,4,6,0,"44.4%",0,5,23.8,4.8,"0.7%",5,85,31
Mitchell Trubisky,2023,4,5,"80.0%",19,3.8,2,0,0,4,9,2,"33.3%",0,5,21.7,4.3,"0.1%",4,28,9
Kenny Pickett,2023,14,32,"43.8%",74,2.3,3,0,1,5,-3,1,"41.7%",0,12,20.7,1.7,"0.7%",4,71,37
Daniel Jones,2023,7,12,"58.3%",45,3.8,2,1,2,8,38,1,"57.1%",0,6,19.6,3.3,"6.9%",3,83,20
Ryan Tannehill,2023,13,26,"50.0%",71,2.7,2,0,4,2,11,1,"33.3%",0,9,17.9,2.0,"0.1%",3,82,28
Easton Stick,2023,5,9,"55.6%",34,3.8,2,0,1,2,3,1,"14.3%",0,5,15.7,3.1,"0.1%",3,37,11
Nick Mullens,2023,7,17,"41.2%",48,2.8,3,1,1,2,3,0,"28.6%",0,5,14.2,2.8,"0.1%",3,51,19
Taylor Heinicke,2023,4,7,"57.1%",19,2.7,2,0,1,1,11,0,"7.7%",0,5,9.9,2.0,"0.0%",2,30,8
Davis Mills,2023,3,6,"50.0%",18,3.0,2,0,0,1,9,0,"9.1%",0,6,9.6,1.6,"0.1%",2,27,7
Tyler Huntley,2023,4,6,"66.7%",37,6.2,2,0,0,3,0,0,"8.6%",0,5,9.5,1.9,"0.0%",2,37,9
Jacoby Brissett,2023,4,8,"50.0%",22,2.8,2,0,0,1,0,0,"11.1%",0,3,8.9,3.0,"1.3%",2,22,9
Jameis Winston,2023,3,4,"75.0%",31,7.8,2,0,0,3,-4,0,"8.3%",0,7,8.8,1.3,"0.3%",2,27,7
Clayton Tune,2023,0,0,"0%",0,0.0,0,0,0,1,1,1,"4.2%",0,8,6.1,0.8,"0.0%",1,1,1
Tyrod Taylor,2023,4,11,"36.4%",30,2.7,1,0,2,2,8,0,"14.3%",0,11,6.0,0.5,"0.2%",1,38,13
Case Keenum,2023,3,5,"60.0%",27,5.4,1,0,0,1,1,0,"9.1%",0,2,5.2,2.6,"0.1%",1,28,6
Trevor Siemian,2023,6,14,"42.9%",29,2.1,1,1,0,0,0,0,"0.0%",0,5,5.2,1.0,"0.0%",1,29,14
PJ Walker,2023,3,12,"25.0%",28,2.3,1,1,0,0,0,0,"0.0%",0,6,5.1,0.9,"0.0%",1,28,12
Dorian Thompson-Robinson,2023,3,15,"20.0%",17,1.1,1,1,0,2,3,0,"22.2%",0,8,5.0,0.6,"0.0%",1,20,17
Tim Boyle,2023,4,6,"66.7%",17,2.8,1,1,1,1,2,0,"33.3%",0,3,4.9,1.6,"0.0%",1,19,7
Sam Darnold,2023,3,8,"37.5%",23,2.9,1,1,1,0,0,0,"0.0%",0,10,4.9,0.5,"4.4%",1,23,8
Andy Dalton,2023,1,1,"100.0%",15,15.0,1,0,1,1,1,0,"12.5%",0,3,4.7,1.6,"0.1%",1,16,2
CJ Beathard,2023,3,10,"30.0%",10,1.0,1,0,4,0,0,0,"0.0%",0,8,4.4,0.6,"0.0%",1,10,10
Mason Rudolph,2023,5,7,"71.4%",23,3.3,0,0,1,3,8,0,"25.0%",0,4,1.7,0.4,"0.1%",0,31,10
Brian Hoyer,2023,4,8,"50.0%",22,2.8,0,0,0,0,0,0,"0.0%",0,3,0.9,0.3,"0.0%",0,22,8
Jaren Hall,2023,2,3,"66.7%",13,4.3,0,0,0,1,3,0,"14.3%",0,3,0.8,0.3,"0.0%",0,16,4
Jarrett Stidham,2023,2,4,"50.0%",17,4.3,0,0,0,0,0,0,"0.0%",0,3,0.7,0.2,"0.6%",0,17,4
Malik Willis,2023,0,1,"0.0%",0,0.0,0,0,2,1,4,0,"16.7%",0,3,0.4,0.1,"0.1%",0,4,2
Drew Lock,2023,2,4,"50.0%",5,1.3,0,0,1,0,0,0,"0.0%",0,4,0.2,0.1,"0.2%",0,5,4
Mike White,2023,1,1,"100.0%",3,3.0,0,0,0,0,0,0,"0.0%",0,6,0.1,0.0,"0.1%",0,3,1
Kyle Trask,2023,0,1,"0.0%",0,0.0,0,0,0,0,0,0,"0.0%",0,2,0.0,0.0,"0.1%",0,0,1
Cooper Rush,2023,1,1,"100.0%",-2,-2.0,0,0,0,0,0,0,"0.0%",0,8,-0.1,0.0,"0.1%",0,-2,1
Kyle Allen,2023,0,0,"0%",0,0.0,0,0,0,2,-2,0,"5.7%",0,7,-0.2,0.0,"0.0%",0,-2,2
